+--+--+--+--+--+--+--+--+
|                       |
+  +--+--+--+--+--+--+  +
|              |        |
+  +--+--+--+  +--+--+  +
|     |     |  |     |  |
+  +--+--+  +  +  +  +--+
|  |     |  |  |  |     |
+--+  +  +  +  +  +--+  +
|     |     |        |  |
+  +--+--+--+--+--+  +  +
|  |           |     |  |
+  +--+--+  +  +  +--+  +
|           |  |  |     |
+--+--+--+--+  +--+  +  +
|                    | g|
+--+--+--+--+--+--+--+--+