+--+--+--+--+--+--+
|        |     |  |
+  +  +  +  +  +  +
|  |  |     |     |
+  +  +--+--+--+  +
|  |  |           |
+--+  +  +--+--+--+
|     |           |
+  +--+--+--+--+  +
|     |        |  |
+  +  +  +--+--+  +
|  |     |        |
+--+--+--+--+--+--+