+--+--+--+--+--+--+--+--+
|p          |           |
+  +  +--+  +--+  +--+  +
|  |  |           |     |
+  +  +--+--+--+--+  +--+
|  |           |     |  |
+--+--+--+--+  +  +--+  +
|           |  |        |
+  +--+--+  +  +--+--+  +
|        |     |        |
+  +--+  +  +--+--+--+--+
|     |  |  |        |  |
+--+--+  +  +  +--+  +  +
|        |  |  |  |     |
+  +--+--+--+  +  +--+--+
|                      g|
+--+--+--+--+--+--+--+--+